1111111111111111111111111
1111111811211111111111111
1111111111111111111111211
1111111111111111111111111
1181111181111111118111111
1111111111111111111111111
1111121111111111111111111
1111111111111111111111111
1111111181111111118111111
1111111111114111111111111
1111121111114111111111111
1111111111114111111111111
1111111111114111111111111
1111711111114121111111111
1111111111114111111111111
1111111111114111111111111
1111111111114111111111111
1111112111114111111111111
1111111111114111111111111
1111111111114111118111111
1111112111114111111111111
1111111111114111111111111
1111111111114111111111111
1118111111114111112111111